kldjhgfdfds
dfh
dfhdj
j
fdh
gh
fhmjgdhfgdfxzx
dghfjgj
hf
jgdhfsgafsd
gsdhfjgj
hkj.

     	1111111
        1000001
11111111100N0011111
1000000000000000011
10110001000000001 1
10100001000000111 1
10111111000001  1 1
10000001000001  1 1
11111111111111111 1
                111
